w                               w
w                               w
w                               w
w                               w
w                               w
w                               w
w                               w
w                               w
w                               w
w                               w
w                               w
w                               w
w                               w
w                               w
w                              ee
w s                            ee
wwwwwwwwwwwwwwwwwwwwwwwwwwwwwwwww
wwwwwwwwwwwwwwwwwwwwwwwwwwwwwwwww
